%%%%%%%%%%%%%%%%%%%%%%%%%
%.......................%
%%%%.................%%%%
%.G...........P........%%
%%%%%%%%%%%%%%%%%%%%%%%%%
