%%%%%%%%%%%%%%%%%%%%%%%%%
%                 G     %
%%%%%%%            %%%%%%
%.G           P      . %%
%%%%%%%%%%%%%%%%%%%%%%%%%
