%%%%%%%%%%%%%%%%%%%%%%%%%%%%%%%%%%%%%%%%%%%%%%%
%P............................................%
%.............................................%
%....%.....%..%%%%%..%%%%%..%%%%%..%%%%%%%....%
%....%.....%..%   %....%......%.......%.......%
%....%.....%..%%%%%....%......%.......%.......%
%....%.....%..%........%......%.......%.......%
%....%%%%%%%..%......%%%%%..%%%%%.....%.......%
%.............................................%
%G............................................%
%............................................G%
%%%%%%%%%%%%%%%%%%%%%%%%%%%%%%%%%%%%%%%%%%%%%%%
